NO TExa.xpm
SO textures/test/south.xpm
WE textures/test/west.xpm
EA textures/test/east.xpm


C 200,200,+250
F 20,20,12



            









 
111111
111111
11111
111



