NO textures/wolfenstein/grey_stone.xpm
SO textures/wolfenstein/purple_stone.xpm
WE textures/wolfenstein/red_brick.xpm
EA textures/wolfenstein/wood.xpm

F 18,53,25
C 153,204,255

111111111111
1         11
1       0001
1000000 0011
10S000000001
111111111111
11         1
111111111111




11111111111111111111111
10100000000000001100111
10101010000000001100111
10001010000000001100111
11111010000000001100111
10000010000000001100111
10111110000000001100111
10100N00000000001100111
11111111000000001100111
11111111111111111111111