NO walls/noudrib.xpm
SO walls/mel-hadd.xpm
WE walls/west.xpm
EA walls/east.xpm

F 47,79,79
C 112,128,144


11111111111111111111
10000000000000010001
100000000000000D0001
10000000000000010001
100000001D1000001101
10000000000000110101
10000000000000010101
100000000000000D0101
10000000000000010101
10N00000000000010101
11111111111111111111