NO walls/noudrib.xpm
SO walls/mel-hadd.xpm
WE walls/west.xpm
EA walls/east.xpm

F 47,79,79
C 112,128,144


111111111111111111111
101000001000000000001
10101010101111111000111111111111111111111111111111111111
100010100010000010001111111111111111111111111111
1111101011111010111011111111111111
100000101000101000001
1011D1101010001111111
101000001010100000101
101011111010111110101
101010001010100010101
101110101010101010101
100000101010001010001
111101101011D11011101
100000101000000010001
101110101010101110111
101000000000100010101
10101D111111111010101
100000000E00000000001
101010111011111111101
101000001000000000001
111111111111111111111